荷兰=Netherlands
瑞士=Switzerland
挪威=Norway
英国=England
希腊=Greece
瑞典=Sweden
俄罗斯=Russia
爱尔兰=Ireland
安道尔=Andorra
奥地利=Austria
比利时=Belgium
梵蒂冈=Vatican
马耳他=Malta
摩纳哥=Monaco
西班牙=Spain
乌克兰=Ukraine
葡萄牙=Portugal
立陶宛=Lithuania
意大利=Italy
匈牙利=Hungary
白俄罗斯=WhiteRussian
所罗门群岛=SolomonIslands
南斯拉夫=Jugoslavia
克罗地亚=Croatia
拉脱维亚=Latvia
爱沙尼亚=Esthonia
保加利亚=Bulgaria
罗马尼亚=Roumania
摩尔多瓦=Moldova
斯洛伐克=Slovakia
斯洛文尼亚=Slovenia
阿尔巴尼亚=Albania
列支敦士登=Liechtenstein
智利=Chile
古巴=Cuba
美国=America
海地=Haiti
巴西=Brazil
圭亚那=Guyana
委内瑞拉=Venezuela
安提瓜和巴布达=Antiguaand Barbuda
阿根廷=Argentina
伯利兹=Belize
巴哈马=Bahamas
巴拿马=Panama
巴拉圭=Paraguay
墨西哥=Mexico
苏里南=Suriname
加拿大=Canada
乌拉圭=Uruguay
厄瓜多尔=Ecuador
格林纳达=Grenada
洪都拉斯=Honduras
多米尼加=Dominica
玻利维亚=Bolivia
秘鲁=Peru
牙买加=Jamaica
危地马拉=Guatemala
中国=China
朝鲜=NorthKorea
老挝=Laos
越南=Vietnam
印度=India
印尼=Indonesia
约旦=Jordan
沙特=Saudi
缅甸=Burma
日本=Japan
蒙古=Mongolia
巴林=Bahrain
不丹=Bhutan
韩国=SouthKorea
泰国=Thailand
文莱=Brunei
阿曼=Oman
也门=Yemen
伊朗=Iran
以色列=Israel
阿富汗=Afghanistan
阿联酋=UnitedArabEmirates
卡塔尔=Qatar
柬埔寨=Cambodia
科威特=Kuwait
土耳其=Turkey
土库曼=Turkmen
尼泊尔=Nepal
黎巴嫩=Lebanon
孟加拉=Bengal
伊拉克=Iraq
哈萨克=Kazakstan
格鲁吉亚=Georgia
马尔代夫=Maldives
马来西亚=Malaysia
菲律宾=Philippines
叙利亚=Syria
新加坡=Singapore
塔吉克=Tajik
吉尔吉斯=Kirghizia
塞浦路斯=Cyprus
斯里兰卡=SriLanka
阿塞拜疆=Azerbaijan
巴基斯坦=Pakistan
乌兹别克=Uzbekistan
巴勒斯坦=Palestine
亚美尼亚=Armenia
埃及=Egypt
贝宁=Benin
多哥=Togo
刚果=Congo
加纳=Ghana
加蓬=Gabon
马里=Mali
中非=CentralAfrica
乍得=Chad
苏丹=Sudan
卢旺达=Rwanda
安哥拉=Angola
布隆迪=Burundi
佛得角=CapeVerde
冈比亚=Gambian
吉布提=Djibouti
几内亚=Guinea
利比亚=Libya
喀麦隆=Cameroon
科摩罗=Comorin
肯尼亚=Kenya
莱索托=Lesotho
尼日尔=Niger
突尼斯=Tunis
塞舌尔=Seychelles
赞比亚=Zambia
马拉维=Malawi
乌干达=Uganda
索马里=Somalia
摩洛哥=Morocco
博茨瓦纳=Botswana
利比里亚=Liberia
阿尔及利亚=Algeria
科特迪瓦=Côted'Ivoire
毛里求斯=Mauritius
民主刚果=Congo
纳米比亚=Namibia
尼日利亚=Nigeria
塞拉利昂=SierraLeone
南非=SouthAfrica
塞内加尔=Senegal
莫桑比克=Mozambique
津巴布韦=Zimbabwe
西撒哈拉=Sahara
斯威士兰=Swaziland
厄立特里亚=Eritrea
坦桑尼亚=Tanzania
赤道几内亚=EquatorialGuinea
布基纳法索=BurkinaFaso
几内亚比绍=Guinea-Bissau
圣多美和普林西比=SaoTomeand=Principe
埃塞俄比亚=Ethiopia
马达加斯加=Madagascar
毛里塔尼亚=Mauritania
冰岛=Iceland
波黑=Bosniaand=Herzegovina
丹麦=Denmark
德国=Germany
波兰=Poland
法国=France
芬兰=Finland
捷克=Czech=Republic
